country,year,china_gdp,gdp,dist,border,bri,imp,exp,total
Afghanistan,2008,4594306848763,10109218068,4184,1,0,2693017,151626761,154319778
Afghanistan,2009,5101702432883,12439087077,4184,1,0,1375868,213366201,214742069
Afghanistan,2010,6087164527421,15856574731,4184,1,0,3680419,175264609,178945028
Afghanistan,2011,7551500425598,17804280538,4184,1,0,4403087,230009966,234413053
Afghanistan,2012,8532230724142,20001615789,4184,1,0,5186565,464033546,469220111
Afghanistan,2013,9570405758740,20561054090,4184,1,0,9595295,328258809,337854104
Afghanistan,2014,10438529153238,20484873230,4184,1,1,17371806,393559251,410931057
Afghanistan,2015,11015542352469,19907111419,4184,1,1,11770644,361819889,373590533
Afghanistan,2016,11137945669351,19362642267,4184,1,1,4534101,430653261,435187362
Afghanistan,2017,12143491448186,20191764940,4184,1,1,3427619,541205985,544633604
Afghanistan,2018,13608151864638,19362969582,4184,1,1,24108670,667867957,691976627
Albania,2008,4594306848763,12881353985,7696,0,0,88259172,196105777,284364949
Albania,2009,5101702432883,12044223458,7696,0,0,64319826,207861575,272181401
Albania,2010,6087164527421,11926962835,7696,0,0,147572616,199277724,346850340
Albania,2011,7551500425598,12890867536,7696,0,0,155367791,281482764,436850555
Albania,2012,8532230724142,12319784701,7696,0,0,142720886,343904583,486625469
Albania,2013,9570405758740,12776277649,7696,0,0,234840915,324596499,559437414
Albania,2014,10438529153238,13228244336,7696,0,1,189322397,378269750,567592147
Albania,2015,11015542352469,11386927679,7696,0,1,127861359,430190806,558052165
Albania,2016,11137945669351,11861353752,7696,0,1,128596467,506540419,635136886
Albania,2017,12143491448186,13025064967,7696,0,1,196222142,454033529,650255671
Albania,2018,13608151864638,15102500898,7696,0,1,107861715,541832246,649693961
Algeria,2008,4594306848763,170997541141,9130,0,0,849219211,3751909956,4601129167
Algeria,2009,5101702432883,137214821177,9130,0,0,946619790,4180239032,5126858822
Algeria,2010,6087164527421,161205065469,9130,0,0,1177317334,3999998875,5177316209
Algeria,2011,7551500425598,200015355528,9130,0,0,1960886720,4471882142,6432768862
Algeria,2012,8532230724142,209062886917,9130,0,0,2311905609,5416657169,7728562778
Algeria,2013,9570405758740,209754763861,9130,0,0,2164546739,6023897368,8188444107
Algeria,2014,10438529153238,213808808747,9130,0,0,1314681787,7395177834,8709859621
Algeria,2015,11015542352469,165978425168,9130,0,0,767362894,7583347042,8350709936
Algeria,2016,11137945669351,160032930354,9130,0,0,331886154,7647851142,7979737296
Algeria,2017,12143491448186,167390266101,9130,0,0,448323792,6784746250,7233070042
Algeria,2018,13608151864638,173757952824,9130,0,0,1178823679,7923382278,9102205957
Armenia,2008,4594306848763,11662040714,5952,0,0,11506191,69212461,80718652
Armenia,2009,5101702432883,8647936748,5952,0,0,23938617,87414900,111353517
Armenia,2010,6087164527421,9260284938,5952,0,0,46703414,117130052,163833466
Armenia,2011,7551500425598,10142111334,5952,0,0,34631988,135722781,170354769
Armenia,2012,8532230724142,10619320049,5952,0,0,35165810,113204371,148370181
Armenia,2013,9570405758740,11121465767,5952,0,0,73138531,119849623,192988154
Armenia,2014,10438529153238,11609512940,5952,0,1,167172701,122809063,289981764
Armenia,2015,11015542352469,10553337673,5952,0,1,208972279,112400450,321372729
Armenia,2016,11137945669351,10546135160,5952,0,1,280618246,111083094,391701340
Armenia,2017,12143491448186,11527458566,5952,0,1,302677119,143851698,446528817
Armenia,2018,13608151864638,12433089919,5952,0,1,313972220,213134241,527106461
Austria,2008,4594306848763,430294287388,7478,0,0,3120815304,1769957801,4890773105
Austria,2009,5101702432883,400172297861,7478,0,0,3405645433,1428189833,4833835266
Austria,2010,6087164527421,391892746545,7478,0,0,4229254595,1854332606,6083587201
Austria,2011,7551500425598,431120310089,7478,0,0,4760979939,2226818600,6987798539
Austria,2012,8532230724142,409425234155,7478,0,0,4723751732,2040341980,6764093712
Austria,2013,9570405758740,430068712972,7478,0,0,5030350258,2037526821,7067877079
Austria,2014,10438529153238,441996131737,7478,0,0,5851704190,2396212239,8247916429
Austria,2015,11015542352469,381817565894,7478,0,0,4968031497,2497728917,7465760414
Austria,2016,11137945669351,395227684139,7478,0,0,5026543805,2240082602,7266626407
Austria,2017,12143491448186,417282900758,7478,0,0,5865911150,2527128524,8393039674
Austria,2018,13608151864638,455285818035,7478,0,0,6923205552,2842355146,9765560698
Azerbaijan,2008,4594306848763,48852482960,5529,0,0,114863737,686098458,800962195
Azerbaijan,2009,5101702432883,44291490421,5529,0,0,128316641,553288806,681605447
Azerbaijan,2010,6087164527421,52902703376,5529,0,0,86547383,846157246,932704629
Azerbaijan,2011,7551500425598,65951627200,5529,0,0,193720359,892618568,1086338927
Azerbaijan,2012,8532230724142,69683935845,5529,0,0,214161731,1069827220,1283988951
Azerbaijan,2013,9570405758740,74164435946,5529,0,0,233583286,868568350,1102151636
Azerbaijan,2014,10438529153238,75244294275,5529,0,1,297062697,645252818,942315515
Azerbaijan,2015,11015542352469,53074468085,5529,0,1,222904058,439145357,662049415
Azerbaijan,2016,11137945669351,37867518957,5529,0,1,412081779,345883254,757965033
Azerbaijan,2017,12143491448186,40865558912,5529,0,1,577453747,386971460,964425207
Azerbaijan,2018,13608151864638,46939529412,5529,0,1,382090298,516277989,898368287
Bahrain,2008,4594306848763,25710877660,6190,0,0,131316949,655076764,786393713
Bahrain,2009,5101702432883,22938218085,6190,0,0,211236915,475314122,686551037
Bahrain,2010,6087164527421,25713271277,6190,0,0,251912196,799503064,1051415260
Bahrain,2011,7551500425598,28776622340,6190,0,0,325836051,880011827,1205847878
Bahrain,2012,8532230724142,30749335106,6190,0,0,348345054,1202781555,1551126609
Bahrain,2013,9570405758740,32539547872,6190,0,0,305180622,1238929155,1544109777
Bahrain,2014,10438529153238,33387686170,6190,0,1,183964392,1231781672,1415746064
Bahrain,2015,11015542352469,31125877660,6190,0,1,111542810,1011846267,1123389077
Bahrain,2016,11137945669351,32250132979,6190,0,1,63722602,790491394,854213996
Bahrain,2017,12143491448186,35432686170,6190,0,1,123945740,902519415,1026465155
Bahrain,2018,13608151864638,37746196809,6190,0,1,150436964,1138819945,1289256909
Bangladesh,2008,4594306848763,91631278239,3027,0,0,131909511,4556074057,4687983568
Bangladesh,2009,5101702432883,102477791472,3027,0,0,140721650,4441066871,4581788521
Bangladesh,2010,6087164527421,115279077465,3027,0,0,268875896,6789096629,7057972525
Bangladesh,2011,7551500425598,128637938711,3027,0,0,449036340,7810657633,8259693973
Bangladesh,2012,8532230724142,133355749482,3027,0,0,479727412,7970093212,8449820624
Bangladesh,2013,9570405758740,149990451022,3027,0,0,602366367,9705086684,10307453051
Bangladesh,2014,10438529153238,172885454931,3027,0,1,761107883,11782272267,12543380150
Bangladesh,2015,11015542352469,195078678697,3027,0,1,816845185,13894707663,14711552848
Bangladesh,2016,11137945669351,221415188000,3027,0,1,869397551,14300635412,15170032963
Bangladesh,2017,12143491448186,249723862487,3027,0,1,875144719,15169021003,16044165722
Bangladesh,2018,13608151864638,274024958966,3027,0,1,985405469,17759539782,18744945251
Belarus,2008,4594306848763,60763483146,6484,0,0,497824135,361362946,859187081
Belarus,2009,5101702432883,50874078052,6484,0,0,529594008,280421170,810015178
Belarus,2010,6087164527421,58665088956,6484,0,0,476097301,795610109,1271707410
Belarus,2011,7551500425598,61757788945,6484,0,0,599466415,705134767,1304601182
Belarus,2012,8532230724142,65685102555,6484,0,0,663130414,919816968,1582947382
Belarus,2013,9570405758740,75527984234,6484,0,0,580512302,872159994,1452672296
Belarus,2014,10438529153238,78813839984,6484,0,1,738277242,1110594383,1848871625
Belarus,2015,11015542352469,56454734397,6484,0,1,1010810007,748901088,1759711095
Belarus,2016,11137945669351,47722657821,6484,0,1,435188908,1090019147,1525208055
Belarus,2017,12143491448186,54726595249,6484,0,1,515383927,933361512,1448745439
Belarus,2018,13608151864638,59662495092,6484,0,1,570989321,1145353173,1716342494
Bhutan,2008,4594306848763,1227808790,2823,1,0,0,8463342,8463342
Bhutan,2009,5101702432883,1234014292,2823,1,0,52378,4116413,4168791
Bhutan,2010,6087164527421,1547991318,2823,1,0,12767,1586121,1598888
Bhutan,2011,7551500425598,1777101316,2823,1,0,75999,17381997,17457996
Bhutan,2012,8532230724142,1781281281,2823,1,0,12684,15603631,15616315
Bhutan,2013,9570405758740,1756215666,2823,1,0,8568,17405171,17413739
Bhutan,2014,10438529153238,1907090813,2823,1,1,104472,11115913,11220385
Bhutan,2015,11015542352469,2003598213,2823,1,1,350067,8115657,8465724
Bhutan,2016,11137945669351,2158972128,2823,1,1,131887,4828959,4960846
Bhutan,2017,12143491448186,2450364929,2823,1,1,176825,6238154,6414979
Bhutan,2018,13608151864638,2446674101,2823,1,1,8,12836574,12836582
Bosnia and Herzegovina,2008,4594306848763,19112739664,7629,0,0,6613839,72829871,79443710
Bosnia and Herzegovina,2009,5101702432883,17613836210,7629,0,0,13562187,35658382,49220569
Bosnia and Herzegovina,2010,6087164527421,17176781337,7629,0,0,17597023,37589221,55186244
Bosnia and Herzegovina,2011,7551500425598,18644723861,7629,0,0,29894728,41434916,71329644
Bosnia and Herzegovina,2012,8532230724142,17226849297,7629,0,0,23300875,46711528,70012403
Bosnia and Herzegovina,2013,9570405758740,18178503835,7629,0,0,20880328,91328214,112208542
Bosnia and Herzegovina,2014,10438529153238,18558343508,7629,0,1,37242373,283984316,321226689
Bosnia and Herzegovina,2015,11015542352469,16211540686,7629,0,1,53729080,59978105,113707185
Bosnia and Herzegovina,2016,11137945669351,16913330694,7629,0,1,43546206,64026820,107573026
Bosnia and Herzegovina,2017,12143491448186,18080118128,7629,0,1,57254159,78816751,136070910
Bosnia and Herzegovina,2018,13608151864638,20161865419,7629,0,1,77400748,109825748,187226496
Brunei Darussalam,2008,4594306848763,14393099069,3882,0,0,88884918,130542756,219427674
Brunei Darussalam,2009,5101702432883,10732366286,3882,0,0,282146357,140454760,422601117
Brunei Darussalam,2010,6087164527421,13707370737,3882,0,0,664329970,367609052,1031939022
Brunei Darussalam,2011,7551500425598,18525319978,3882,0,0,566815740,744393812,1311209552
Brunei Darussalam,2012,8532230724142,19048495519,3882,0,0,373085183,1252438159,1625523342
Brunei Darussalam,2013,9570405758740,18093829923,3882,0,0,89803505,1703776234,1793579739
Brunei Darussalam,2014,10438529153238,17098342541,3882,0,1,189717197,1746814598,1936531795
Brunei Darussalam,2015,11015542352469,12930394938,3882,0,1,101156073,1407408747,1508564820
Brunei Darussalam,2016,11137945669351,11400854268,3882,0,1,221546472,510852391,732398863
Brunei Darussalam,2017,12143491448186,12128104859,3882,0,1,351809713,637592774,989402487
Brunei Darussalam,2018,13608151864638,13567351175,3882,0,1,247640850,1597616589,1845257439
Bulgaria,2008,4594306848763,54409138498,7370,0,0,216781956,1124844722,1341626678
Bulgaria,2009,5101702432883,51884481410,7370,0,0,140997020,596052099,737049119
Bulgaria,2010,6087164527421,50610058210,7370,0,0,322999381,660906308,983905689
Bulgaria,2011,7551500425598,57418414504,7370,0,0,459981528,1005615637,1465597165
Bulgaria,2012,8532230724142,53903022339,7370,0,0,840157165,1054597122,1894754287
Bulgaria,2013,9570405758740,55555171010,7370,0,0,956742907,1116984160,2073727067
Bulgaria,2014,10438529153238,56814543481,7370,0,1,984859638,1178062014,2162921652
Bulgaria,2015,11015542352469,50201314895,7370,0,1,748306600,1043259427,1791566027
Bulgaria,2016,11137945669351,53240950226,7370,0,1,590108479,1055552573,1645661052
Bulgaria,2017,12143491448186,58220973783,7370,0,1,969183021,1169047355,2138230376
Bulgaria,2018,13608151864638,65132951116,7370,0,1,1149082938,1442480646,2591563584
Cambodia,2008,4594306848763,10351914093,3338,0,0,38828183,1095543284,1134371467
Cambodia,2009,5101702432883,10401851851,3338,0,0,36892151,907060919,943953070
Cambodia,2010,6087164527421,11242275199,3338,0,0,93627088,1347341970,1440969058
Cambodia,2011,7551500425598,12829541141,3338,0,0,184297983,2314810078,2499108061
Cambodia,2012,8532230724142,14054443213,3338,0,0,215313850,2708103063,2923416913
Cambodia,2013,9570405758740,15227991395,3338,0,0,363634853,3409507478,3773142331
Cambodia,2014,10438529153238,16702610842,3338,0,1,482914653,3274737955,3757652608
Cambodia,2015,11015542352469,18049954289,3338,0,1,666595118,3763390571,4429985689
Cambodia,2016,11137945669351,20159271965,3338,0,1,830513470,3928684744,4759198214
Cambodia,2017,12143491448186,22180376506,3338,0,1,1007581678,4783198403,5790780081
Cambodia,2018,13608151864638,24542474061,3338,0,1,1377337531,6022950063,7400287594
Croatia,2008,4594306848763,70288911413,7657,0,0,67835740,1741988454,1809824194
Croatia,2009,5101702432883,62666161453,7657,0,0,74856035,1118521596,1193377631
Croatia,2010,6087164527421,59807966533,7657,0,0,50890177,1343731335,1394621512
Croatia,2011,7551500425598,62354235671,7657,0,0,79531000,1540929756,1620460756
Croatia,2012,8532230724142,56494436183,7657,0,0,74514004,1299885707,1374399711
Croatia,2013,9570405758740,58056951042,7657,0,0,104265835,1389942736,1494208571
Croatia,2014,10438529153238,57642879510,7657,0,1,100662533,1027325028,1127987561
Croatia,2015,11015542352469,49530656285,7657,0,1,111789045,985561959,1097351004
Croatia,2016,11137945669351,51596929180,7657,0,1,161440422,1016752933,1178193355
Croatia,2017,12143491448186,55319620158,7657,0,1,183083779,1159640718,1342724497
Croatia,2018,13608151864638,60971699315,7657,0,1,212017381,1329773380,1541790761
Czech Republic,2008,4594306848763,235718586901,7474,0,0,1002704234,5497482854,6500187088
Czech Republic,2009,5101702432883,206179982164,7474,0,0,1131849047,5023771859,6155620906
Czech Republic,2010,6087164527421,207477857919,7474,0,0,1727987185,7121515998,8849503183
Czech Republic,2011,7551500425598,227948349666,7474,0,0,2318995632,7669407130,9988402762
Czech Republic,2012,8532230724142,207376427021,7474,0,0,2406876645,6323551170,8730427815
Czech Republic,2013,9570405758740,209402444996,7474,0,0,2614923008,6837794906,9452717914
Czech Republic,2014,10438529153238,207818330724,7474,0,1,2986688756,7992899362,10979588118
Czech Republic,2015,11015542352469,186829940546,7474,0,1,2780453405,8226132073,11006585478
Czech Republic,2016,11137945669351,195090272403,7474,0,1,2951543251,8058523909,11010067160
Czech Republic,2017,12143491448186,215913545038,7474,0,1,3695705524,8792969695,12488675219
Czech Republic,2018,13608151864638,245225882903,7474,0,1,4406185938,11912529366,16318715304
Djibouti,2008,4594306848763,999105339,7767,0,0,1791549,252267597,254059146
Djibouti,2009,5101702432883,1049110685,7767,0,0,109578,294601830,294711408
Djibouti,2010,6087164527421,1128611700,7767,0,0,690795,444061130,444751925
Djibouti,2011,7551500425598,1239144502,7767,0,0,176023,508853299,509029322
Djibouti,2012,8532230724142,1353632942,7767,0,0,617415,902579630,903197045
Djibouti,2013,9570405758740,2042817163,7767,0,0,273727,1018883781,1019157508
Djibouti,2014,10438529153238,2216200810,7767,0,1,1684901,1112181416,1113866317
Djibouti,2015,11015542352469,2445484583,7767,0,1,898189,1980815513,1981713702
Djibouti,2016,11137945669351,2618587757,7767,0,1,134100,2148396599,2148530699
Djibouti,2017,12143491448186,2766868072,7767,0,1,15498,2175409974,2175425472
Djibouti,2018,13608151864638,2955912228,7767,0,1,204,1871676062,1871676266
"Egypt, Arab Rep.",2008,4594306848763,162818181818,7558,0,0,428939103,5874260276,6303199379
"Egypt, Arab Rep.",2009,5101702432883,188982374701,7558,0,0,752542778,5107359456,5859902234
"Egypt, Arab Rep.",2010,6087164527421,218888324505,7558,0,0,917930190,6040984268,6958914458
"Egypt, Arab Rep.",2011,7551500425598,236001858960,7558,0,0,1518340176,7283232684,8801572860
"Egypt, Arab Rep.",2012,8532230724142,279372758362,7558,0,0,1320736724,8223921373,9544658097
"Egypt, Arab Rep.",2013,9570405758740,288586231502,7558,0,0,1851606760,8362674701,10214281461
"Egypt, Arab Rep.",2014,10438529153238,305529656458,7558,0,1,1159516629,10460509601,11620026230
"Egypt, Arab Rep.",2015,11015542352469,332698041031,7558,0,1,917844080,11958576936,12876421016
"Egypt, Arab Rep.",2016,11137945669351,332927833278,7558,0,1,553212429,10436255851,10989468280
"Egypt, Arab Rep.",2017,12143491448186,235369129338,7558,0,1,1341934131,9485643131,10827577262
"Egypt, Arab Rep.",2018,13608151864638,250894760351,7558,0,1,1834527721,12020880441,13855408162
Estonia,2008,4594306848763,24371299985,6380,0,0,88694380,588130160,676824540
Estonia,2009,5101702432883,19744110447,6380,0,0,79331724,362295983,441627707
Estonia,2010,6087164527421,19685033799,6380,0,0,181908389,676737922,858646311
Estonia,2011,7551500425598,23394843529,6380,0,0,205417486,1130854729,1336272215
Estonia,2012,8532230724142,23192709239,6380,0,0,135749789,1233665715,1369415504
Estonia,2013,9570405758740,25271407239,6380,0,0,199575171,1109820135,1309395306
Estonia,2014,10438529153238,26773472962,6380,0,1,225498366,1146097776,1371596142
Estonia,2015,11015542352469,23048864243,6380,0,1,234963583,953287539,1188251122
Estonia,2016,11137945669351,23996451498,6380,0,1,211791329,963644014,1175435343
Estonia,2017,12143491448186,26792757827,6380,0,1,260339003,1006352315,1266691318
Estonia,2018,13608151864638,30732144529,6380,0,1,245474319,1032202716,1277677035
Ethiopia,2008,4594306848763,27066912635,8320,0,0,81656179,1230719309,1312375488
Ethiopia,2009,5101702432883,32437389116,8320,0,0,214755559,1252460488,1467216047
Ethiopia,2010,6087164527421,29933790334,8320,0,0,273970311,1209615368,1483585679
Ethiopia,2011,7551500425598,31952763089,8320,0,0,292059109,885361446,1177420555
Ethiopia,2012,8532230724142,43310721414,8320,0,0,309365546,1529869658,1839235204
Ethiopia,2013,9570405758740,47648211133,8320,0,0,315687550,1868466390,2184153940
Ethiopia,2014,10438529153238,55612228234,8320,0,0,489953733,2922309224,3412262957
Ethiopia,2015,11015542352469,64589334979,8320,0,0,380349712,3440867341,3821217053
Ethiopia,2016,11137945669351,74296618481,8320,0,0,419419894,3214476645,3633896539
Ethiopia,2017,12143491448186,81760441159,8320,0,0,357582736,2664554880,3022137616
Ethiopia,2018,13608151864638,84355604753,8320,0,0,345312966,2537682497,2882995463
Georgia,2008,4594306848763,12795076469,5861,0,0,3526532,292886424,296412956
Georgia,2009,5101702432883,10766836277,5861,0,0,17868168,191957710,209825878
Georgia,2010,6087164527421,12243505583,5861,0,0,41802268,274931757,316734025
Georgia,2011,7551500425598,15107441447,5861,0,0,38105242,761069088,799174330
Georgia,2012,8532230724142,16488403076,5861,0,0,33582229,740330065,773912294
Georgia,2013,9570405758740,17189491403,5861,0,0,54455596,862092297,916547893
Georgia,2014,10438529153238,17627060089,5861,0,1,53110774,908676000,961786774
Georgia,2015,11015542352469,14953950557,5861,0,1,43785338,768675246,812460584
Georgia,2016,11137945669351,15141758567,5861,0,1,53564327,745243603,798807930
Georgia,2017,12143491448186,16242956764,5861,0,1,67590956,912618656,980209612
Georgia,2018,13608151864638,17599660629,5861,0,1,53914314,1102602778,1156517092
Greece,2008,4594306848763,354460802549,7634,0,0,185480146,4074585710,4260065856
Greece,2009,5101702432883,330000252153,7634,0,0,213027756,3458064962,3671092718
Greece,2010,6087164527421,299361576558,7634,0,0,390395766,3958942836,4349338602
Greece,2011,7551500425598,287797822093,7634,0,0,353606705,3949368486,4302975191
Greece,2012,8532230724142,245670666639,7634,0,0,427351728,3593168231,4020519959
Greece,2013,9570405758740,239862011450,7634,0,0,433266752,3218976138,3652242890
Greece,2014,10438529153238,237029579261,7634,0,1,345667164,4185607495,4531274659
Greece,2015,11015542352469,196591353761,7634,0,1,285500609,3664980363,3950480972
Greece,2016,11137945669351,195222443513,7634,0,1,283105786,4201429389,4484535175
Greece,2017,12143491448186,203085551429,7634,0,1,430040263,4751381411,5181421674
Greece,2018,13608151864638,218031844584,7634,0,1,564533756,6542160671,7106694427
Hungary,2008,4594306848763,158136326478,7357,0,0,1382204047,6096852444,7479056491
Hungary,2009,5101702432883,130760312877,7357,0,0,1466425962,5343600691,6810026653
Hungary,2010,6087164527421,131135561228,7357,0,0,2197691683,6518313682,8716005365
Hungary,2011,7551500425598,141109576981,7357,0,0,2452217389,6806021560,9258238949
Hungary,2012,8532230724142,128153691809,7357,0,0,2323098017,5737959719,8061057736
Hungary,2013,9570405758740,135409048034,7357,0,0,2715148301,5692280446,8407428747
Hungary,2014,10438529153238,140558786480,7357,0,1,3259899630,5764165984,9024065614
Hungary,2015,11015542352469,124529741437,7357,0,1,2875551415,5197452275,8073003690
Hungary,2016,11137945669351,127507473626,7357,0,1,3464230161,5422687552,8886917713
Hungary,2017,12143491448186,141510583020,7357,0,1,4077223959,6049345107,10126569066
Hungary,2018,13608151864638,157882912778,7357,0,1,4338742384,6540410303,10879152687
India,2008,4594306848763,1198895582138,3781,1,0,20258886260,31585380667,51844266927
India,2009,5101702432883,1341886602799,3781,1,0,13714288921,29666559641,43380848562
India,2010,6087164527421,1675615335601,3781,1,0,20846313421,40913958297,61760271718
India,2011,7551500425598,1823050405350,3781,1,0,23372278613,50536415932,73908694545
India,2012,8532230724142,1827637859136,3781,1,0,18797190537,47677451834,66474642371
India,2013,9570405758740,1856722121395,3781,1,0,16970269592,48432411237,65402680829
India,2014,10438529153238,2039127446299,3781,1,1,16358690559,54217421728,70576112287
India,2015,11015542352469,2103587813813,3781,1,1,13368553464,58228027086,71596580550
India,2016,11137945669351,2290432075124,3781,1,1,11764125238,58397760569,70161885807
India,2017,12143491448186,2652242857924,3781,1,1,16345370678,68042252505,84387623183
India,2018,13608151864638,2718732231258,3781,1,1,18850036974,76880636625,95730673599
Indonesia,2008,4594306848763,510228634992,5193,0,0,14322934795,17193114300,31516049095
Indonesia,2009,5101702432883,539580085612,5193,0,0,13663782584,14720623749,28384406333
Indonesia,2010,6087164527421,755094160363,5193,0,0,20795188520,21953565243,42748753763
Indonesia,2011,7551500425598,892969107923,5193,0,0,31337083878,29220943981,60558027859
Indonesia,2012,8532230724142,917869910106,5193,0,0,31935986395,34285243915,66221230310
Indonesia,2013,9570405758740,912524136718,5193,0,0,31424278600,36930489821,68354768421
Indonesia,2014,10438529153238,890814755233,5193,0,1,24485246982,39059605524,63544852506
Indonesia,2015,11015542352469,860854235065,5193,0,1,19886194033,34341964720,54228158753
Indonesia,2016,11137945669351,931877364178,5193,0,1,21414036371,32117494749,53531531120
Indonesia,2017,12143491448186,1015423455783,5193,0,1,28574305510,34757384544,63331690054
Indonesia,2018,13608151864638,1042173300626,5193,0,1,34154685183,43246345320,77401030503
"Iran, Islamic Rep.",2008,4594306848763,406070949554,5613,0,0,19594195353,8163428066,27757623419
"Iran, Islamic Rep.",2009,5101702432883,414059094949,5613,0,0,13286547277,7918687116,21205234393
"Iran, Islamic Rep.",2010,6087164527421,487069570464,5613,0,0,18300891267,11092187779,29393079046
"Iran, Islamic Rep.",2011,7551500425598,583500357530,5613,0,0,30332972751,14761998860,45094971611
"Iran, Islamic Rep.",2012,8532230724142,598853401276,5613,0,0,24869408279,11598798609,36468206888
"Iran, Islamic Rep.",2013,9570405758740,467414852231,5613,0,0,25389863878,14036645328,39426509206
"Iran, Islamic Rep.",2014,10438529153238,434474616832,5613,0,1,27503849631,24338486490,51842336121
"Iran, Islamic Rep.",2015,11015542352469,385874474399,5613,0,1,16057447101,17770106932,33827554033
"Iran, Islamic Rep.",2016,11137945669351,418976679729,5613,0,1,14827192366,16417272588,31244464954
"Iran, Islamic Rep.",2017,12143491448186,454012768724,5613,0,1,18553692986,18584814804,37138507790
"Iran, Islamic Rep.",2018,13608151864638,446105000000,5613,0,1,21098883154,14008983835,35107866989
Iraq,2008,4594306848763,131613661510,6305,0,0,1381664347,1271161565,2652825912
Iraq,2009,5101702432883,111660855043,6305,0,0,3298111051,1838448828,5136559879
Iraq,2010,6087164527421,138516722650,6305,0,0,6275191100,3589866730,9865057830
Iraq,2011,7551500425598,185749664444,6305,0,0,10443633871,3824651342,14268285213
Iraq,2012,8532230724142,218000986223,6305,0,0,12655773459,4911784801,17567558260
Iraq,2013,9570405758740,234637674957,6305,0,0,17984764256,6894088320,24878852576
Iraq,2014,10438529153238,234648370497,6305,0,1,20761239088,7743841287,28505080375
Iraq,2015,11015542352469,177498577313,6305,0,1,12674629883,7909228953,20583858836
Iraq,2016,11137945669351,174878976034,6305,0,1,10663270913,7547857704,18211128617
Iraq,2017,12143491448186,195473049875,6305,0,1,13814112257,8330414675,22144526932
Iraq,2018,13608151864638,224228010478,6305,0,1,22466146012,7917674274,30383820286
Israel,2008,4594306848763,216105164967,7152,0,0,1792823275,4257001665,6049824940
Israel,2009,5101702432883,207468170892,7152,0,0,1524121036,3652651123,5176772159
Israel,2010,6087164527421,233995676195,7152,0,0,2607390704,5037049627,7644440331
Israel,2011,7551500425598,261468634231,7152,0,0,3037704818,6740797880,9778502698
Israel,2012,8532230724142,257180147032,7152,0,0,2922830923,6988137193,9910968116
Israel,2013,9570405758740,292636164001,7152,0,0,3181317438,7645304406,10826621844
Israel,2014,10438529153238,309558454719,7152,0,1,3140636714,7739105565,10879742279
Israel,2015,11015542352469,299813121213,7152,0,1,2802031169,8615948860,11417980029
Israel,2016,11137945669351,318950599018,7152,0,1,3172902895,8174292923,11347195818
Israel,2017,12143491448186,353253406955,7152,0,1,4206235859,8918466720,13124702579
Israel,2018,13608151864638,370587977154,7152,0,1,4631373736,9315784334,13947158070
Italy,2008,4594306848763,2398856598799,8145,0,0,11639033821,26628788111,38267821932
Italy,2009,5101702432883,2191241872742,8145,0,0,11020282280,20243631792,31263914072
Italy,2010,6087164527421,2134017843247,8145,0,0,14006239062,31139647035,45145886097
Italy,2011,7551500425598,2291991045770,8145,0,0,17578443451,33692730999,51271174450
Italy,2012,8532230724142,2087077032435,8145,0,0,16064755279,25656013136,41720768415
Italy,2013,9570405758740,2141315327318,8145,0,0,17573805100,25752660052,43326465152
Italy,2014,10438529153238,2159133919744,8145,0,0,19281902871,28756397409,48038300280
Italy,2015,11015542352469,1835899237320,8145,0,1,16819824938,27834410422,44654235360
Italy,2016,11137945669351,1875579883543,8145,0,1,16713185425,26360471715,43073657140
Italy,2017,12143491448186,1956960611691,8145,0,1,20497942487,29199961821,49697904308
Italy,2018,13608151864638,2083864259623,8145,0,1,21154352155,33263242520,54417594675
Jordan,2008,4594306848763,22279907003,7068,0,0,123175273,1826131253,1949306526
Jordan,2009,5101702432883,24154000000,7068,0,0,112256561,1965980047,2078236608
Jordan,2010,6087164527421,26795901408,7068,0,0,164706001,1888900117,2053606118
Jordan,2011,7551500425598,29244647887,7068,0,0,256721830,2512724020,2769445850
Jordan,2012,8532230724142,31371056338,7068,0,0,297103074,2958958357,3256061431
Jordan,2013,9570405758740,34064873239,7068,0,0,169875101,3434555469,3604430570
Jordan,2014,10438529153238,36329267606,7068,0,1,263204026,3364531210,3627735236
Jordan,2015,11015542352469,38043450704,7068,0,1,287521299,3424402679,3711923978
Jordan,2016,11137945669351,39196676056,7068,0,1,211161137,2954400451,3165561588
Jordan,2017,12143491448186,40708943662,7068,0,1,279185370,2803608942,3082794312
Jordan,2018,13608151864638,42231295775,7068,0,1,214181822,2973957886,3188139708
Kazakhstan,2008,4594306848763,133441612247,3282,1,0,7727827943,9824510357,17552338300
Kazakhstan,2009,5101702432883,115308661143,3282,1,0,6255599827,7748172050,14003771877
Kazakhstan,2010,6087164527421,148047348241,3282,1,0,11108591383,9320400745,20428992128
Kazakhstan,2011,7551500425598,192626507972,3282,1,0,15349865821,9566529533,24916395354
Kazakhstan,2012,8532230724142,207998568866,3282,1,0,14675446558,11001238439,25676684997
Kazakhstan,2013,9570405758740,236634552078,3282,1,0,16050838003,12545123569,28595961572
Kazakhstan,2014,10438529153238,221415572820,3282,1,1,9741822440,12709849378,22451671818
Kazakhstan,2015,11015542352469,184388432149,3282,1,1,5848946920,8441240875,14290187795
Kazakhstan,2016,11137945669351,137278320084,3282,1,1,4805078580,8292320845,13097399425
Kazakhstan,2017,12143491448186,166805800596,3282,1,1,6378690611,11564442930,17943133541
Kazakhstan,2018,13608151864638,179339994859,3282,1,1,8529553750,11326580893,19856134643
Kenya,2008,4594306848763,35895153328,9214,0,0,34722717,1249332629,1284055346
Kenya,2009,5101702432883,37021512049,9214,0,0,29661843,1277439292,1307101135
Kenya,2010,6087164527421,40000088347,9214,0,0,39207733,1786303416,1825511149
Kenya,2011,7551500425598,41953433591,9214,0,0,59690991,2368775109,2428466100
Kenya,2012,8532230724142,50412754861,9214,0,0,52407939,2788761718,2841169657
Kenya,2013,9570405758740,55096728048,9214,0,0,52782890,3217480883,3270263773
Kenya,2014,10438529153238,61448046802,9214,0,1,77039062,4930627241,5007666303
Kenya,2015,11015542352469,64007750179,9214,0,1,98743024,5914315875,6013058899
Kenya,2016,11137945669351,69188755511,9214,0,1,97135495,5587646821,5684782316
Kenya,2017,12143491448186,78757391333,9214,0,1,166820240,5034650207,5201470447
Kenya,2018,13608151864638,87908262520,9214,0,1,174199705,5204943662,5379143367
Kuwait,2008,4594306848763,147395089286,6228,0,0,5038814695,1751301291,6790115986
Kuwait,2009,5101702432883,105963168867,6228,0,0,3500920762,1542682893,5043603655
Kuwait,2010,6087164527421,115419050942,6228,0,0,6708788039,1848592266,8557380305
Kuwait,2011,7551500425598,154027536232,6228,0,0,9175204536,2128414638,11303619174
Kuwait,2012,8532230724142,174070025009,6228,0,0,10467164717,2089318501,12556483218
Kuwait,2013,9570405758740,174161495063,6228,0,0,9586638189,2675508872,12262147061
Kuwait,2014,10438529153238,162631763879,6228,0,1,10004964203,3428724738,13433688941
Kuwait,2015,11015542352469,114567298106,6228,0,1,7497065368,3772671285,11269736653
Kuwait,2016,11137945669351,109420059583,6228,0,1,6370284298,3000886535,9371170833
Kuwait,2017,12143491448186,120707550280,6228,0,1,8934950001,3112773877,12047723878
Kuwait,2018,13608151864638,140645364238,6228,0,1,15359440567,3321341039,18680781606
Kyrgyz Republic,2008,4594306848763,5139957785,3475,1,0,121327867,9212049706,9333377573
Kyrgyz Republic,2009,5101702432883,4690062255,3475,1,0,48450429,5227522345,5275972774
Kyrgyz Republic,2010,6087164527421,4794357795,3475,1,0,72069065,4127513399,4199582464
Kyrgyz Republic,2011,7551500425598,6197766119,3475,1,0,98121281,4878288660,4976409941
Kyrgyz Republic,2012,8532230724142,6605139933,3475,1,0,89020942,5073515540,5162536482
Kyrgyz Republic,2013,9570405758740,7335027592,3475,1,0,62350108,5075346113,5137696221
Kyrgyz Republic,2014,10438529153238,7468096567,3475,1,1,55424061,5242519736,5297943797
Kyrgyz Republic,2015,11015542352469,6678178340,3475,1,1,58570893,4282122824,4340693717
Kyrgyz Republic,2016,11137945669351,6813092066,3475,1,1,71234903,5605425556,5676660459
Kyrgyz Republic,2017,12143491448186,7702934800,3475,1,1,87055356,5336808026,5423863382
Kyrgyz Republic,2018,13608151864638,8092836609,3475,1,1,54359461,5546955221,5601314682
Lao PDR,2008,4594306848763,5443915121,2771,1,0,134258761,268113530,402372291
Lao PDR,2009,5101702432883,5832915387,2771,1,0,367319183,376649989,743969172
Lao PDR,2010,6087164527421,7127792630,2771,1,0,601489848,483622848,1085112696
Lao PDR,2011,7551500425598,8749241114,2771,1,0,827588282,476254609,1303842891
Lao PDR,2012,8532230724142,10191350120,2771,1,0,787757979,937094035,1724852014
Lao PDR,2013,9570405758740,11942230508,2771,1,0,1010079275,1722576814,2732656089
Lao PDR,2014,10438529153238,13268458232,2771,1,1,1777883187,1839475080,3617358267
Lao PDR,2015,11015542352469,14390442307,2771,1,1,1547337273,1225758347,2773095620
Lao PDR,2016,11137945669351,15805692546,2771,1,1,1359607754,986966609,2346574363
Lao PDR,2017,12143491448186,16853087485,2771,1,1,1604997325,1419351176,3024348501
Lao PDR,2018,13608151864638,17953786416,2771,1,1,2029602507,1455739477,3485341984
Latvia,2008,4594306848763,35657998831,6533,0,0,18010420,848979999,866990419
Latvia,2009,5101702432883,26250900751,6533,0,0,26001369,452298736,478300105
Latvia,2010,6087164527421,23796118301,6533,0,0,39061626,794160307,833221933
Latvia,2011,7551500425598,28246551197,6533,0,0,63436323,1192946688,1256383011
Latvia,2012,8532230724142,28170812352,6533,0,0,68827118,1312708947,1381536065
Latvia,2013,9570405758740,30276485436,6533,0,0,99157559,1374267489,1473425048
Latvia,2014,10438529153238,31382780146,6533,0,1,146909554,1316699354,1463608908
Latvia,2015,11015542352469,27090019663,6533,0,1,144585911,1022505750,1167091661
Latvia,2016,11137945669351,27734140217,6533,0,1,132204537,1062374292,1194578829
Latvia,2017,12143491448186,30198231776,6533,0,1,177240332,1148242366,1325482698
Latvia,2018,13608151864638,34409229178,6533,0,1,212840277,1169822423,1382662700
Lebanon,2008,4594306848763,29227542760,6989,0,0,13273975,1083449145,1096723120
Lebanon,2009,5101702432883,35477299024,6989,0,0,8976689,1056822426,1065799115
Lebanon,2010,6087164527421,38419626534,6989,0,0,27275311,1319452860,1346728171
Lebanon,2011,7551500425598,40075674295,6989,0,0,25949541,1458393031,1484342572
Lebanon,2012,8532230724142,44230727695,6989,0,0,20326571,1691955088,1712281659
Lebanon,2013,9570405758740,46866579768,6989,0,0,45579124,2490830754,2536409878
Lebanon,2014,10438529153238,48296099502,6989,0,1,25387258,2604860826,2630248084
Lebanon,2015,11015542352469,49973893201,6989,0,1,17322912,2285530495,2302853407
Lebanon,2016,11137945669351,51239050083,6989,0,1,17672825,2100338023,2118010848
Lebanon,2017,12143491448186,53393799668,6989,0,1,23040153,2010610880,2033651033
Lebanon,2018,13608151864638,56639155556,6989,0,1,49080614,1982773056,2031853670
Libya,2008,4594306848763,87140405361,8736,0,0,2588993333,1640447152,4229440485
Libya,2009,5101702432883,63028320702,8736,0,0,3173884051,2002911519,5176795570
Libya,2010,6087164527421,74773444901,8736,0,0,4515614893,2061358105,6576972998
Libya,2011,7551500425598,34699395524,8736,0,0,2063575283,720379163,2783954446
Libya,2012,8532230724142,81873662519,8736,0,0,6375901670,2384239155,8760140825
Libya,2013,9570405758740,65502870174,8736,0,0,2038928004,2834679489,4873607493
Libya,2014,10438529153238,41142722414,8736,0,0,726370287,2157612006,2883982293
Libya,2015,11015542352469,27842131480,8736,0,0,951549550,1892016554,2843566104
Libya,2016,11137945669351,26197143268,8736,0,0,345620186,1184612556,1530232742
Libya,2017,12143491448186,37881431913,8736,0,0,1362657776,1027969894,2390627670
Libya,2018,13608151864638,48364208571,8736,0,0,4742280287,1433045467,6175325754
Lithuania,2008,4594306848763,47850551149,6579,0,0,29129678,1059978297,1089107975
Lithuania,2009,5101702432883,37440673478,6579,0,0,38113255,655714444,693827699
Lithuania,2010,6087164527421,37024718365,6579,0,0,42148264,982340835,1024489099
Lithuania,2011,7551500425598,43419061504,6579,0,0,87606619,1335101120,1422707739
Lithuania,2012,8532230724142,42826586830,6579,0,0,89497283,1630884984,1720382267
Lithuania,2013,9570405758740,46450990764,6579,0,0,124785537,1686177991,1810963528
Lithuania,2014,10438529153238,48485169331,6579,0,1,157486780,1658290764,1815777544
Lithuania,2015,11015542352469,41392396558,6579,0,1,138784693,1210902623,1349687316
Lithuania,2016,11137945669351,43021972485,6579,0,1,164011310,1290938626,1454949936
Lithuania,2017,12143491448186,47632961168,6579,0,1,255151046,1600274355,1855425401
Lithuania,2018,13608151864638,53429066429,6579,0,1,331790735,1763528890,2095319625
North Macedonia,2008,4594306848763,9909548411,7543,0,0,13275161,70721048,83996209
North Macedonia,2009,5101702432883,9401731496,7543,0,0,24093158,56009508,80102666
North Macedonia,2010,6087164527421,9407168702,7543,0,0,91756384,52783088,144539472
North Macedonia,2011,7551500425598,10494632699,7543,0,0,154308487,91810658,246119145
North Macedonia,2012,8532230724142,9745251126,7543,0,0,139606216,88749833,228356049
North Macedonia,2013,9570405758740,10817712139,7543,0,0,107972555,63476178,171448733
North Macedonia,2014,10438529153238,11362272838,7543,0,1,90584590,76663641,167248231
North Macedonia,2015,11015542352469,10064515432,7543,0,1,132697664,86532159,219229823
North Macedonia,2016,11137945669351,10672471861,7543,0,1,46705307,90046619,136751926
North Macedonia,2017,12143491448186,11279509014,7543,0,1,86688785,78041448,164730233
North Macedonia,2018,13608151864638,12672131053,7543,0,1,48374215,107788398,156162613
Madagascar,2008,4594306848763,10725137931,9653,0,0,65171536,602593259,667764795
Madagascar,2009,5101702432883,9616879571,9653,0,0,54821973,395383093,450205066
Madagascar,2010,6087164527421,9982711338,9653,0,0,105382497,396790704,502173201
Madagascar,2011,7551500425598,11551819618,9653,0,0,103388560,503376232,606764792
Madagascar,2012,8532230724142,11578974888,9653,0,0,114442664,542413969,656856633
Madagascar,2013,9570405758740,12423555269,9653,0,0,173906315,642961433,816867748
Madagascar,2014,10438529153238,12522957228,9653,0,0,118076353,752678100,870754453
Madagascar,2015,11015542352469,11323020829,9653,0,0,171132242,865235356,1036367598
Madagascar,2016,11137945669351,11848613735,9653,0,0,160793418,942957351,1103750769
Madagascar,2017,12143491448186,13176313594,9653,0,0,227093068,1007487260,1234580328
Madagascar,2018,13608151864638,13853432868,9653,0,0,214706590,1015755813,1230462403
Malaysia,2008,4594306848763,230813897716,4332,0,0,32101396273,21455168798,53556565071
Malaysia,2009,5101702432883,202257625195,4332,0,0,32330690825,19631938849,51962629674
Malaysia,2010,6087164527421,255016609233,4332,0,0,50430149705,23802061384,74232211089
Malaysia,2011,7551500425598,297951960784,4332,0,0,62136639680,27886048451,90022688131
Malaysia,2012,8532230724142,314443149443,4332,0,0,58304935012,36525700292,94830635304
Malaysia,2013,9570405758740,323277158907,4332,0,0,60153183872,45930593403,106083777275
Malaysia,2014,10438529153238,338061963396,4332,0,1,55652242622,46353387874,102005630496
Malaysia,2015,11015542352469,301354756113,4332,0,1,53277330687,43980386746,97257717433
Malaysia,2016,11137945669351,301255454041,4332,0,1,49269636528,37660167391,86929803919
Malaysia,2017,12143491448186,318958236443,4332,0,1,54426139443,41712282701,96138422144
Malaysia,2018,13608151864638,358581943446,4332,0,1,63321953929,45848411856,109170365785
Moldova,2008,4594306848763,6054849885,6749,0,0,2614341,71268032,73882373
Moldova,2009,5101702432883,5439422031,6749,0,0,3257552,72570917,75828469
Moldova,2010,6087164527421,6974960426,6749,0,0,6711692,80522683,87234375
Moldova,2011,7551500425598,8414360571,6749,0,0,12828838,97490563,110319401
Moldova,2012,8532230724142,8709165249,6749,0,0,18625264,123942001,142567265
Moldova,2013,9570405758740,9496684622,6749,0,0,18585927,112628646,131214573
Moldova,2014,10438529153238,9510219299,6749,0,1,24792891,115204983,139997874
Moldova,2015,11015542352469,7745231660,6749,0,1,21470579,99955411,121425990
Moldova,2016,11137945669351,8071480541,6749,0,1,24371526,76628050,100999576
Moldova,2017,12143491448186,9669759987,6749,0,1,33963935,97915867,131879802
Moldova,2018,13608151864638,11443671436,6749,0,1,38425899,108656211,147082110
Mongolia,2008,4594306848763,5623216449,1168,1,0,1525607206,907827596,2433434802
Mongolia,2009,5101702432883,4583850368,1168,1,0,1338679282,1057930574,2396609856
Mongolia,2010,6087164527421,7189481824,1168,1,0,2549854481,1449762159,3999616640
Mongolia,2011,7551500425598,10409797649,1168,1,0,3700776083,2731757636,6432533719
Mongolia,2012,8532230724142,12292770631,1168,1,0,3944213728,2653509346,6597723074
Mongolia,2013,9570405758740,12582122604,1168,1,0,3509546975,2449591582,5959138557
Mongolia,2014,10438529153238,12226514722,1168,1,1,5102087078,2216381986,7318469064
Mongolia,2015,11015542352469,11749620620,1168,1,1,3795376573,1570701173,5366077746
Mongolia,2016,11137945669351,11186734674,1168,1,1,3622600860,988539201,4611140061
Mongolia,2017,12143491448186,11425755280,1168,1,1,5167313200,1235611572,6402924772
Mongolia,2018,13608151864638,13066749138,1168,1,1,6341575086,1646742395,7988317481
Montenegro,2008,4594306848763,4545674528,7662,0,0,2125379,86595277,88720656
Montenegro,2009,5101702432883,4159328980,7662,0,0,744640,76822598,77567238
Montenegro,2010,6087164527421,4139192053,7662,0,0,3063845,71082965,74146810
Montenegro,2011,7551500425598,4538199889,7662,0,0,12055617,89981869,102037486
Montenegro,2012,8532230724142,4087725813,7662,0,0,21458127,145761043,167219170
Montenegro,2013,9570405758740,4464261816,7662,0,0,16142805,86383454,102526259
Montenegro,2014,10438529153238,4587928884,7662,0,1,53560445,157066329,210626774
Montenegro,2015,11015542352469,4052913386,7662,0,1,24274424,134147473,158421897
Montenegro,2016,11137945669351,4374128319,7662,0,1,32582358,108327938,140910296
Montenegro,2017,12143491448186,4844592067,7662,0,1,66401113,132455707,198856820
Montenegro,2018,13608151864638,5504166667,7662,0,1,42190188,178355702,220545890
Morocco,2008,4594306848763,92507257784,10044,0,0,461058836,2348926014,2809984850
Morocco,2009,5101702432883,92897320376,10044,0,0,375013702,2129257748,2504271450
Morocco,2010,6087164527421,93216746662,10044,0,0,452321985,2484471737,2936793722
Morocco,2011,7551500425598,101370474295,10044,0,0,475627503,3042649431,3518276934
Morocco,2012,8532230724142,98266306615,10044,0,0,558415936,3131192523,3689608459
Morocco,2013,9570405758740,106825649872,10044,0,0,531428150,3271645442,3803073592
Morocco,2014,10438529153238,110081248587,10044,0,0,518503700,2962993198,3481496898
Morocco,2015,11015542352469,101179808076,10044,0,0,521521041,2897184380,3418705421
Morocco,2016,11137945669351,103311649248,10044,0,0,553456726,3078776968,3632233694
Morocco,2017,12143491448186,109714300454,10044,0,0,650597142,3176226241,3826823383
Morocco,2018,13608151864638,117921394402,10044,0,0,711067910,3690127742,4401195652
Mozambique,2008,4594306848763,12574681498,11323,0,0,125882374,295994949,421877323
Mozambique,2009,5101702432883,11899763735,11323,0,0,177554369,339133810,516688179
Mozambique,2010,6087164527421,11087646868,11323,0,0,201077529,496391036,697468565
Mozambique,2011,7551500425598,14381552433,11323,0,0,257241199,700247026,957488225
Mozambique,2012,8532230724142,16350804543,11323,0,0,403320479,940887034,1344207513
Mozambique,2013,9570405758740,16974320551,11323,0,0,454874745,1199293242,1654167987
Mozambique,2014,10438529153238,17716084108,11323,0,0,1649822358,1968739789,3618562147
Mozambique,2015,11015542352469,15950969019,11323,0,0,452616050,1938023358,2390639408
Mozambique,2016,11137945669351,11936999283,11323,0,0,479356871,1308557797,1787914668
Mozambique,2017,12143491448186,13219084261,11323,0,0,528715219,1306746135,1835461354
Mozambique,2018,13608151864638,14717223207,11323,0,0,651383583,1869325088,2520708671
Myanmar,2008,4594306848763,31862554102,3222,1,0,647548911,1977766301,2625315212
Myanmar,2009,5101702432883,36906181381,3222,1,0,646122186,2261242729,2907364915
Myanmar,2010,6087164527421,49540813342,3222,1,0,966087338,3475524257,4441611595
Myanmar,2011,7551500425598,59977326086,3222,1,0,1679872844,4821497462,6501370306
Myanmar,2012,8532230724142,59937797559,3222,1,0,1298225942,5673756230,6971982172
Myanmar,2013,9570405758740,60269734045,3222,1,0,2856866581,7338688821,10195555402
Myanmar,2014,10438529153238,65446199788,3222,1,1,15601279451,9367646907,24968926358
Myanmar,2015,11015542352469,59687410897,3222,1,1,5449295046,9650911459,15100206505
Myanmar,2016,11137945669351,63256184700,3222,1,1,4097708683,8187651272,12285359955
Myanmar,2017,12143491448186,66719084253,3222,1,1,4526347998,8948464266,13474812264
Myanmar,2018,13608151864638,71214803378,3222,1,1,4718842085,10567874244,15286716329
Nepal,2008,4594306848763,12545438605,3158,1,0,5975687,375612156,381587843
Nepal,2009,5101702432883,12854985464,3158,1,0,5290031,408888751,414178782
Nepal,2010,6087164527421,16002656434,3158,1,0,11415993,731256545,742672538
Nepal,2011,7551500425598,18913574371,3158,1,0,13864962,1181225863,1195090825
Nepal,2012,8532230724142,18851513891,3158,1,0,29519666,1968161680,1997681346
Nepal,2013,9570405758740,19271168018,3158,1,0,43249899,2210886765,2254136664
Nepal,2014,10438529153238,20002968838,3158,1,1,47067400,2283579293,2330646693
Nepal,2015,11015542352469,21410840909,3158,1,1,32002120,832705292,864707412
Nepal,2016,11137945669351,21185922408,3158,1,1,22405605,866127148,888532753
Nepal,2017,12143491448186,25180583770,3158,1,1,17853684,966954543,984808227
Nepal,2018,13608151864638,29040398982,3158,1,1,21992360,1078402175,1100394535
Oman,2008,4594306848763,60905331599,5666,0,0,11626847464,794515075,12421362539
Oman,2009,5101702432883,48388296489,5666,0,0,5409904082,747450792,6157354874
Oman,2010,6087164527421,58642392718,5666,0,0,9779203580,944496934,10723700514
Oman,2011,7551500425598,67937581274,5666,0,0,14876687929,998176839,15874864768
Oman,2012,8532230724142,76689206762,5666,0,0,16974956957,1811575743,18786532700
Oman,2013,9570405758740,78784395319,5666,0,0,21040612892,1900844050,22941456942
Oman,2014,10438529153238,81076723017,5666,0,1,23795855636,2065380888,25861236524
Oman,2015,11015542352469,68921456437,5666,0,1,15047419802,2116393034,17163812836
Oman,2016,11137945669351,65941482445,5666,0,1,12041024465,2147698465,14188722930
Oman,2017,12143491448186,70597919376,5666,0,1,13383277944,2316452581,15699730525
Oman,2018,13608151864638,79276723017,5666,0,1,18821413653,2875747953,21697161606
Pakistan,2008,4594306848763,170077814106,3888,1,0,1006799565,6051066209,7057865774
Pakistan,2009,5101702432883,168152775283,3888,1,0,1260255889,5515073607,6775329496
Pakistan,2010,6087164527421,177165635077,3888,1,0,1730948987,6937791618,8668740605
Pakistan,2011,7551500425598,213587413184,3888,1,0,2118460216,8439729435,10558189651
Pakistan,2012,8532230724142,224383620830,3888,1,0,3140393520,9276492101,12416885621
Pakistan,2013,9570405758740,231218567179,3888,1,0,3196840329,11019596122,14216436451
Pakistan,2014,10438529153238,244360888751,3888,1,1,2753869881,13244481938,15998351819
Pakistan,2015,11015542352469,270556131701,3888,1,1,2474763994,16441888411,18916652405
Pakistan,2016,11137945669351,278654637738,3888,1,1,1912592895,17232654059,19145246954
Pakistan,2017,12143491448186,304567253219,3888,1,1,1833219000,18250788585,20084007585
Pakistan,2018,13608151864638,314588210501,3888,1,1,2179815773,16967144897,19146960670
Philippines,2008,4594306848763,174195136253,2842,0,0,19504743994,9132231065,28636975059
Philippines,2009,5101702432883,168334601260,2842,0,0,11946610452,8584707500,20531317952
Philippines,2010,6087164527421,199590775190,2842,0,0,16220254753,11540277320,27760532073
Philippines,2011,7551500425598,224143083707,2842,0,0,17992317070,14255388286,32247705356
Philippines,2012,8532230724142,250092092998,2842,0,0,19643205303,16732210058,36375415361
Philippines,2013,9570405758740,271836123724,2842,0,0,18181829139,19868125345,38049954484
Philippines,2014,10438529153238,284584522899,2842,0,1,20984132158,23473577223,44457709381
Philippines,2015,11015542352469,292774099014,2842,0,1,18965654304,26670791210,45636445514
Philippines,2016,11137945669351,304897590205,2842,0,1,17395891173,29836566657,47232457830
Philippines,2017,12143491448186,313619747740,2842,0,1,19239177209,32065932447,51305109656
Philippines,2018,13608151864638,330910343611,2842,0,1,20595680299,35111186384,55706866683
Poland,2008,4594306848763,533815789474,6958,0,0,1394431815,9040367590,10434799405
Poland,2009,5101702432883,439796160379,6958,0,0,1504764187,7561767520,9066531707
Poland,2010,6087164527421,479321460551,6958,0,0,1696613007,9438306983,11134919990
Poland,2011,7551500425598,528832185770,6958,0,0,2047975509,10939548803,12987524312
Poland,2012,8532230724142,500360816828,6958,0,0,1997765599,12386657177,14384422776
Poland,2013,9570405758740,524234322597,6958,0,0,2231797119,12574874708,14806671827
Poland,2014,10438529153238,545389126644,6958,0,1,2934739056,14256798574,17191537630
Poland,2015,11015542352469,477576866958,6958,0,1,2741951454,14344871703,17086823157
Poland,2016,11137945669351,472028000406,6958,0,1,2537722070,15094067047,17631789117
Poland,2017,12143491448186,526216495118,6958,0,1,3353507795,17873049958,21226557753
Poland,2018,13608151864638,585663814824,6958,0,1,3646181428,20944255812,24590437240
Portugal,2008,4594306848763,262344779552,9688,0,0,387489834,2317102263,2704592097
Portugal,2009,5101702432883,243701635176,9688,0,0,480929852,1923516206,2404446058
Portugal,2010,6087164527421,237880908318,9688,0,0,754426018,2513317692,3267743710
Portugal,2011,7551500425598,244797226567,9688,0,0,1162063935,2801433742,3963497677
Portugal,2012,8532230724142,216236608774,9688,0,0,1514582001,2501157554,4015739555
Portugal,2013,9570405758740,226369502104,9688,0,0,1399460781,2506863699,3906324480
Portugal,2014,10438529153238,229596170847,9688,0,0,1663291480,3137073216,4800364696
Portugal,2015,11015542352469,199313894327,9688,0,0,1461543018,2894923138,4356466156
Portugal,2016,11137945669351,206286022782,9688,0,0,1582818088,4002119526,5584937614
Portugal,2017,12143491448186,220811110492,9688,0,0,2139178524,3445214944,5584393468
Portugal,2018,13608151864638,240674524464,9688,0,0,2250093954,3768702404,6018796358
Qatar,2008,4594306848763,115270054945,6165,0,0,1311626096,1074163869,2385789965
Qatar,2009,5101702432883,97798351648,6165,0,0,1376154007,872411299,2248565306
Qatar,2010,6087164527421,125122306346,6165,0,0,2455837047,855444268,3311281315
Qatar,2011,7551500425598,167775274725,6165,0,0,4694308733,1198757273,5893066006
Qatar,2012,8532230724142,186833516484,6165,0,0,7278102972,1205100145,8483203117
Qatar,2013,9570405758740,198727747253,6165,0,0,8463353081,1710907973,10174261054
Qatar,2014,10438529153238,206224725275,6165,0,1,8336727789,2254011137,10590738926
Qatar,2015,11015542352469,161739835165,6165,0,1,4614366284,2275641175,6890007459
Qatar,2016,11137945669351,151732142857,6165,0,1,4012373868,1515659122,5528032990
Qatar,2017,12143491448186,166928571429,6165,0,1,6400274202,1682329963,8082604165
Qatar,2018,13608151864638,191362087912,6165,0,1,9091342850,2488627647,11579970497
Romania,2008,4594306848763,214313628965,7078,0,0,359895832,2889919681,3249815513
Romania,2009,5101702432883,174103695930,7078,0,0,433095291,2377287745,2810383036
Romania,2010,6087164527421,166225180150,7078,0,0,755266641,3004462173,3759728814
Romania,2011,7551500425598,183443154235,7078,0,0,947047802,3453775070,4400822872
Romania,2012,8532230724142,171196268958,7078,0,0,979775941,2797186371,3776962312
Romania,2013,9570405758740,190949066979,7078,0,0,1207501781,2822536841,4030038622
Romania,2014,10438529153238,199626806402,7078,0,1,1520667345,3223177591,4743844936
Romania,2015,11015542352469,177893451831,7078,0,1,1294952121,3162240075,4457192196
Romania,2016,11137945669351,188494136776,7078,0,1,1455221038,3447669471,4902890509
Romania,2017,12143491448186,211695422579,7078,0,1,1824318039,3777960251,5602278290
Romania,2018,13608151864638,239552516744,7078,0,1,2170014461,4512111180,6682125641
Russian Federation,2008,4594306848763,1660846387625,5807,1,0,23832761729,33075849922,56908611651
Russian Federation,2009,5101702432883,1222644282202,5807,1,0,21282952148,17513771415,38796723563
Russian Federation,2010,6087164527421,1524917468442,5807,1,0,25913993644,29612073703,55526067347
Russian Federation,2011,7551500425598,2051661732060,5807,1,0,40362599801,38903017967,79265617768
Russian Federation,2012,8532230724142,2210256976945,5807,1,0,44138278872,44056551091,88194829963
Russian Federation,2013,9570405758740,2297128039058,5807,1,0,39667828205,49591171963,89259000168
Russian Federation,2014,10438529153238,2059984158438,5807,1,1,41593505497,53676944136,95270449633
Russian Federation,2015,11015542352469,1363594369578,5807,1,1,33258662857,34756877250,68015540107
Russian Federation,2016,11137945669351,1282723881134,5807,1,1,32260147552,37339600736,69599748288
Russian Federation,2017,12143491448186,1578624060588,5807,1,1,41390293056,42830599817,84220892873
Russian Federation,2018,13608151864638,1657554647150,5807,1,1,58886549221,48005202953,106891752174
Saudi Arabia,2008,4594306848763,519796800000,6612,0,0,31022697923,10823467968,41846165891
Saudi Arabia,2009,5101702432883,429097866667,6612,0,0,23620243562,8977851553,32598095115
Saudi Arabia,2010,6087164527421,528207200000,6612,0,0,32829047702,10366444546,43195492248
Saudi Arabia,2011,7551500425598,671238840107,6612,0,0,49467519877,14849707392,64317227269
Saudi Arabia,2012,8532230724142,735974843360,6612,0,0,54861126276,18452900814,73314027090
Saudi Arabia,2013,9570405758740,746647127413,6612,0,0,53450710541,18739813766,72190524307
Saudi Arabia,2014,10438529153238,756350347333,6612,0,1,48508025980,20575241927,69083267907
Saudi Arabia,2015,11015542352469,654269902880,6612,0,1,30021050937,21612927984,51633978921
Saudi Arabia,2016,11137945669351,644935541440,6612,0,1,23626019106,18650906502,42276925608
Saudi Arabia,2017,12143491448186,688586133333,6612,0,1,31761873271,18375008211,50136881482
Saudi Arabia,2018,13608151864638,786521831572,6612,0,1,45898673109,17560589328,63459262437
Serbia,2008,4594306848763,52194221469,7433,0,0,12281010,492520004,504801014
Serbia,2009,5101702432883,45162894381,7433,0,0,28643216,308320998,336964214
Serbia,2010,6087164527421,41819468692,7433,0,0,55116378,345016345,400132723
Serbia,2011,7551500425598,49258136129,7433,0,0,77891459,396353094,474244553
Serbia,2012,8532230724142,43309252921,7433,0,0,101566427,412875586,514442013
Serbia,2013,9570405758740,48394239475,7433,0,0,180126901,431911532,612038433
Serbia,2014,10438529153238,47062206678,7433,0,1,112740979,424563062,537304041
Serbia,2015,11015542352469,39628550869,7433,0,1,133736754,415096978,548833732
Serbia,2016,11137945669351,40630392019,7433,0,1,162696164,431663170,594359334
Serbia,2017,12143491448186,44120424392,7433,0,1,211584906,545639029,757223935
Serbia,2018,13608151864638,50597289147,7433,0,1,224518531,728997500,953516031
Singapore,2008,4594306848763,193611986713,4463,0,0,20171264550,32305805355,52477069905
Singapore,2009,5101702432883,194152286009,4463,0,0,17796637195,30066363191,47863000386
Singapore,2010,6087164527421,239809387605,4463,0,0,24728920282,32347238005,57076158287
Singapore,2011,7551500425598,279351168707,4463,0,0,28139648591,35570137217,63709785808
Singapore,2012,8532230724142,295087220933,4463,0,0,28529562909,40750209041,69279771950
Singapore,2013,9570405758740,307576360585,4463,0,0,30064514713,45831864575,75896379288
Singapore,2014,10438529153238,314851156183,4463,0,1,30828733314,48911174763,79739908077
Singapore,2015,11015542352469,308004146058,4463,0,1,27580763340,51942439609,79523202949
Singapore,2016,11137945669351,318068476294,4463,0,1,26014248910,44495953063,70510201973
Singapore,2017,12143491448186,338406474039,4463,0,1,34249623689,45019300478,79268924167
Singapore,2018,13608151864638,364156657770,4463,0,1,33638315735,49817841244,83456156979
Slovak Republic,2008,4594306848763,100469509301,7437,0,0,983732625,1966040236,2949772861
Slovak Republic,2009,5101702432883,89046289247,7437,0,0,897393008,1399014510,2296407518
Slovak Republic,2010,6087164527421,90183986822,7437,0,0,1790561881,1958477027,3749038908
Slovak Republic,2011,7551500425598,98997521242,7437,0,0,3457346257,2512599983,5969946240
Slovak Republic,2012,8532230724142,94416582465,7437,0,0,3655226501,2423049977,6078276478
Slovak Republic,2013,9570405758740,98723944144,7437,0,0,3458155736,3084436614,6542592350
Slovak Republic,2014,10438529153238,101171217101,7437,0,1,3376076644,2828495793,6204572437
Slovak Republic,2015,11015542352469,88457167724,7437,0,1,2237316045,2794467680,5031783725
Slovak Republic,2016,11137945669351,89640741266,7437,0,1,2410166238,2861362255,5271528493
Slovak Republic,2017,12143491448186,95241436352,7437,0,1,2584962634,2729478548,5314441182
Slovak Republic,2018,13608151864638,105904632156,7437,0,1,5244318952,2558824517,7803143469
Slovenia,2008,4594306848763,55552508715,7734,0,0,131557653,964205569,1095763222
Slovenia,2009,5101702432883,50368056543,7734,0,0,126469046,770101310,896570356
Slovenia,2010,6087164527421,48161250935,7734,0,0,176569526,1385668573,1562238099
Slovenia,2011,7551500425598,51516367350,7734,0,0,202040417,1675371443,1877411860
Slovenia,2012,8532230724142,46580457470,7734,0,0,256030373,1566640643,1822671016
Slovenia,2013,9570405758740,48401896410,7734,0,0,302799041,1832812279,2135611320
Slovenia,2014,10438529153238,49930685013,7734,0,1,331464602,1991941939,2323406541
Slovenia,2015,11015542352469,43090173062,7734,0,1,289506573,2091734751,2381241324
Slovenia,2016,11137945669351,44651537260,7734,0,1,436858380,2269426806,2706285186
Slovenia,2017,12143491448186,48441722816,7734,0,1,495352405,2886929825,3382282230
Slovenia,2018,13608151864638,54007972106,7734,0,1,590974974,4435174362,5026149336
Sri Lanka,2008,4594306848763,40713812310,5157,0,0,60540670,1630093609,1690634279
Sri Lanka,2009,5101702432883,42066217872,5157,0,0,70148623,1569465378,1639614001
Sri Lanka,2010,6087164527421,56725749222,5157,0,0,102275267,1994847732,2097122999
Sri Lanka,2011,7551500425598,65292753005,5157,0,0,152887599,2988723989,3141611588
Sri Lanka,2012,8532230724142,68434409315,5157,0,0,161955151,3001304898,3163260049
Sri Lanka,2013,9570405758740,74317806538,5157,0,0,182564147,3436548807,3619112954
Sri Lanka,2014,10438529153238,79356449841,5157,0,1,248272984,3792797469,4041070453
Sri Lanka,2015,11015542352469,80604080689,5157,0,1,258515964,4304045370,4562561334
Sri Lanka,2016,11137945669351,82401038710,5157,0,1,273444163,4286880100,4560324263
Sri Lanka,2017,12143491448186,88019706804,5157,0,1,310030297,4087995801,4398026098
Sri Lanka,2018,13608151864638,88900770858,5157,0,1,340882256,4266679878,4607562134
Tajikistan,2008,4594306848763,5161337336,4063,1,0,20243530,1479682759,1499926289
Tajikistan,2009,5101702432883,4979481980,4063,1,0,184984833,1217574287,1402559120
Tajikistan,2010,6087164527421,5642178580,4063,1,0,56048418,1376501471,1432549889
Tajikistan,2011,7551500425598,6522732203,4063,1,0,72227602,1996777606,2069005208
Tajikistan,2012,8532230724142,7633049792,4063,1,0,108828584,1747870228,1856698812
Tajikistan,2013,9570405758740,8448469838,4063,1,0,88751269,1869363600,1958114869
Tajikistan,2014,10438529153238,9112544556,4063,1,1,47698839,2468236340,2515935179
Tajikistan,2015,11015542352469,7854602392,4063,1,1,52034554,1795387872,1847422426
Tajikistan,2016,11137945669351,6952678127,4063,1,1,31244886,1725083792,1756328678
Tajikistan,2017,12143491448186,7157865188,4063,1,1,46736549,1301374985,1348111534
Tajikistan,2018,13608151864638,7522947810,4063,1,1,76804094,1425933857,1502737951
Tanzania,2008,4594306848763,27941177435,9407,0,0,131588471,950438907,1082027378
Tanzania,2009,5101702432883,29081425282,9407,0,0,195968354,914052483,1110020837
Tanzania,2010,6087164527421,32014249841,9407,0,0,406945183,1253126610,1660071793
Tanzania,2011,7551500425598,34657139495,9407,0,0,489896901,1653631731,2143528632
Tanzania,2012,8532230724142,39650530214,9407,0,0,379281002,2089721998,2469003000
Tanzania,2013,9570405758740,45680532614,9407,0,0,552548245,3140702390,3693250635
Tanzania,2014,10438529153238,49964788814,9407,0,1,435101902,3843566338,4278668240
Tanzania,2015,11015542352469,47378599025,9407,0,1,377844200,4278864540,4656708740
Tanzania,2016,11137945669351,49774021003,9407,0,1,315826807,3566861307,3882688114
Tanzania,2017,12143491448186,53320625959,9407,0,1,335859050,3119554166,3455413216
Tanzania,2018,13608151864638,58001200572,9407,0,1,393915222,3590574198,3984489420
Thailand,2008,4594306848763,291383081232,3292,0,0,25656736974,15636354387,41293091361
Thailand,2009,5101702432883,281710095725,3292,0,0,24896941868,13307098106,38204039974
Thailand,2010,6087164527421,341105009515,3292,0,0,33193365016,19741222106,52934587122
Thailand,2011,7551500425598,370818747397,3292,0,0,39039795886,25694603599,64734399485
Thailand,2012,8532230724142,397558094270,3292,0,0,38551206040,31196768378,69747974418
Thailand,2013,9570405758740,420333333333,3292,0,0,38522680528,32717903843,71240584371
Thailand,2014,10438529153238,407339361696,3292,0,1,38331928398,34289227963,72621156361
Thailand,2015,11015542352469,401295970240,3292,0,1,37168745238,38290804015,75459549253
Thailand,2016,11137945669351,412352789520,3292,0,1,38532342814,37182731174,75715073988
Thailand,2017,12143491448186,455275517239,3292,0,1,41596082905,38541726588,80137809493
Thailand,2018,13608151864638,504992757705,3292,0,1,44918670224,42974255961,87892926185
Timor-Leste,2008,4594306848763,4391368100,5449,0,0,106162,9426360,9532522
Timor-Leste,2009,5101702432883,3199666700,5449,0,0,22765,23260240,23283005
Timor-Leste,2010,6087164527421,3998961300,5449,0,0,250487,42832008,43082495
Timor-Leste,2011,7551500425598,5672048700,5449,0,0,1742791,70432762,72175553
Timor-Leste,2012,8532230724142,6661664600,5449,0,0,688156,62473520,63161676
Timor-Leste,2013,9570405758740,5637671700,5449,0,0,397037,47386367,47783404
Timor-Leste,2014,10438529153238,4041637000,5449,0,1,99850,60341649,60441499
Timor-Leste,2015,11015542352469,3092624800,5449,0,1,724858,104529645,105254503
Timor-Leste,2016,11137945669351,2503532100,5449,0,1,291606,164272800,164564406
Timor-Leste,2017,12143491448186,2487269400,5449,0,1,1573168,132596622,134169790
Timor-Leste,2018,13608151864638,2581000000,5449,0,1,3014403,132781191,135795594
Tunisia,2008,4594306848763,44856586316,8661,0,0,90308471,696860678,787169149
Tunisia,2009,5101702432883,43454935940,8661,0,0,107523728,711180932,818704660
Tunisia,2010,6087164527421,44050929160,8661,0,0,124900376,994893386,1119793762
Tunisia,2011,7551500425598,45810626509,8661,0,0,219462498,1112727084,1332189582
Tunisia,2012,8532230724142,45044112939,8661,0,0,176976451,1391786110,1568762561
Tunisia,2013,9570405758740,46251061734,8661,0,0,176729459,1263158664,1439888123
Tunisia,2014,10438529153238,47632326088,8661,0,0,211919795,1235778742,1447698537
Tunisia,2015,11015542352469,43173480832,8661,0,0,183799263,1237428731,1421227994
Tunisia,2016,11137945669351,41802653631,8661,0,0,138846826,1295839939,1434686765
Tunisia,2017,12143491448186,39813383484,8661,0,0,198163138,1327986910,1526150048
Tunisia,2018,13608151864638,39871132268,8661,0,0,194964649,1415923926,1610888575
Turkey,2008,4594306848763,764335657638,7072,0,0,1962933289,10606311968,12569245257
Turkey,2009,5101702432883,644639901974,7072,0,0,1745485488,8333534857,10079020345
Turkey,2010,6087164527421,771901768870,7072,0,0,3164059033,11942037327,15106096360
Turkey,2011,7551500425598,832523680908,7072,0,0,3123228248,15613704584,18736932832
Turkey,2012,8532230724142,873982246612,7072,0,0,3511810027,15585293352,19097103379
Turkey,2013,9570405758740,950579413123,7072,0,0,4486234345,17746990917,22233225262
Turkey,2014,10438529153238,934185915386,7072,0,1,3705395699,19305457610,23010853309
Turkey,2015,11015542352469,859796872678,7072,0,1,2943637695,18607841074,21551478769
Turkey,2016,11137945669351,863721648069,7072,0,1,2785414654,16686640520,19472055174
Turkey,2017,12143491448186,852676778301,7072,0,1,3783430252,18121507516,21904937768
Turkey,2018,13608151864638,771350330455,7072,0,1,3762714131,17864201230,21626915361
Turkmenistan,2008,4594306848763,19271523179,4944,0,0,28440391,801935714,830376105
Turkmenistan,2009,5101702432883,20214385965,4944,0,0,38491278,915699494,954190772
Turkmenistan,2010,6087164527421,22583157895,4944,0,0,1044518804,525117179,1569635983
Turkmenistan,2011,7551500425598,29233333333,4944,0,0,4693173232,784359736,5477532968
Turkmenistan,2012,8532230724142,35164210526,4944,0,0,8673382453,1699117414,10372499867
Turkmenistan,2013,9570405758740,39197543860,4944,0,0,8893256737,1137643740,10030900477
Turkmenistan,2014,10438529153238,43524210526,4944,0,1,9516158297,954281603,10470439900
Turkmenistan,2015,11015542352469,35799714286,4944,0,1,7827660790,815468646,8643129436
Turkmenistan,2016,11137945669351,36180000000,4944,0,1,5563294660,338478864,5901773524
Turkmenistan,2017,12143491448186,37926285714,4944,0,1,6575125628,368116552,6943242180
Turkmenistan,2018,13608151864638,40761142857,4944,0,1,8119370114,316778792,8436148906
Ukraine,2008,4594306848763,179816790705,6467,0,0,1194016897,7566283427,8760300324
Ukraine,2009,5101702432883,117113410001,6467,0,0,2172540409,3603782079,5776322488
Ukraine,2010,6087164527421,136013155905,6467,0,0,2163583168,5563830973,7727414141
Ukraine,2011,7551500425598,163159671670,6467,0,0,3264665067,7147075079,10411740146
Ukraine,2012,8532230724142,175781379051,6467,0,0,3031234265,7324648972,10355883237
Ukraine,2013,9570405758740,183310146378,6467,0,0,3272866934,7849224932,11122091866
Ukraine,2014,10438529153238,133503411376,6467,0,1,3483543735,5106228655,8589772390
Ukraine,2015,11015542352469,91030959455,6467,0,1,3555798287,3515713254,7071511541
Ukraine,2016,11137945669351,93355993629,6467,0,1,2490794646,4216952797,6707747443
Ukraine,2017,12143491448186,112190355158,6467,0,1,2339641836,5040644515,7380286351
Ukraine,2018,13608151864638,130832374405,6467,0,1,2635775875,7025517349,9661293224
United Arab Emirates,2008,4594306848763,315474615739,5845,0,0,4613250116,23643689550,28256939666
United Arab Emirates,2009,5101702432883,253547358747,5845,0,0,2595229265,18632295505,21227524770
United Arab Emirates,2010,6087164527421,289787338325,5845,0,0,4451552488,21235460530,25687013018
United Arab Emirates,2011,7551500425598,350666031314,5845,0,0,8306605795,26812847746,35119453541
United Arab Emirates,2012,8532230724142,374590605854,5845,0,0,10851923958,29568342622,40420266580
United Arab Emirates,2013,9570405758740,390107556161,5845,0,0,12823525641,33411294711,46234820352
United Arab Emirates,2014,10438529153238,403137100068,5845,0,1,15763356629,39034507149,54797863778
United Arab Emirates,2015,11015542352469,358135057862,5845,0,1,11514031960,37020164366,48534196326
United Arab Emirates,2016,11137945669351,357045064670,5845,0,1,9994362641,30066955630,40061318271
United Arab Emirates,2017,12143491448186,377701060177,5845,0,1,12311158312,28723965341,41035123653
United Arab Emirates,2018,13608151864638,414178942592,5845,0,1,16281246908,29902886596,46184133504
Uzbekistan,2008,4594306848763,29549438884,3940,0,0,328881786,1277814306,1606696092
Uzbekistan,2009,5101702432883,33689223673,3940,0,0,349418724,1560538745,1909957469
Uzbekistan,2010,6087164527421,46679875794,3940,0,0,1300780404,1181023679,2481804083
Uzbekistan,2011,7551500425598,56516280748,3940,0,0,807314965,1359242440,2166557405
Uzbekistan,2012,8532230724142,63628854499,3940,0,0,1091832887,1783338724,2875171611
Uzbekistan,2013,9570405758740,68997168338,3940,0,0,1938092728,2613355048,4551447776
Uzbekistan,2014,10438529153238,76658542757,3940,0,1,1597910202,2678213964,4276124166
Uzbekistan,2015,11015542352469,81847410182,3940,0,1,1267063757,2228760931,3495824688
Uzbekistan,2016,11137945669351,81779012351,3940,0,1,1607057922,2007463677,3614521599
Uzbekistan,2017,12143491448186,59159945321,3940,0,1,1471448860,2749423215,4220872075
Uzbekistan,2018,13608151864638,50499921558,3940,0,1,2324394704,3942096467,6266491171
Vietnam,2008,4594306848763,99130304099,2321,1,0,4336317470,15122132632,19458450102
Vietnam,2009,5101702432883,106014659770,2321,1,0,4746739792,16300914499,21047654291
Vietnam,2010,6087164527421,115931749697,2321,1,0,6984262461,23101555926,30085818387
Vietnam,2011,7551500425598,135539438560,2321,1,0,11116531136,29091568152,40208099288
Vietnam,2012,8532230724142,155820001920,2321,1,0,16229125413,34212586980,50441712393
Vietnam,2013,9570405758740,171222025117,2321,1,0,16891892668,48586298201,65478190869
Vietnam,2014,10438529153238,186204652922,2321,1,1,19906397835,63730014143,83636411978
Vietnam,2015,11015542352469,193241108710,2321,1,1,29831745312,66017019778,95848765090
Vietnam,2016,11137945669351,205276172135,2321,1,1,37171603826,61094096781,98265700607
Vietnam,2017,12143491448186,223779865815,2321,1,1,50374616976,71617248156,121991865132
Vietnam,2018,13608151864638,245213686369,2321,1,1,64087359833,84015798650,148103158483
"Yemen, Rep.",2008,4594306848763,26910851362,7524,0,0,3209872995,1184583997,4394456992
"Yemen, Rep.",2009,5101702432883,25130274124,7524,0,0,1237511097,1168418833,2405929930
"Yemen, Rep.",2010,6087164527421,30906749533,7524,0,0,2779080663,1223859123,4002939786
"Yemen, Rep.",2011,7551500425598,32726417878,7524,0,0,3135702068,1104281308,4239983376
"Yemen, Rep.",2012,8532230724142,35401339869,7524,0,0,3604053344,1955098652,5559151996
"Yemen, Rep.",2013,9570405758740,40415233436,7524,0,0,3061300935,2138817020,5200117955
"Yemen, Rep.",2014,10438529153238,43228585321,7524,0,1,2932853594,2201314090,5134167684
"Yemen, Rep.",2015,11015542352469,42628328212,7524,0,1,898137960,1429967840,2328105800
"Yemen, Rep.",2016,11137945669351,30968242968,7524,0,1,166028327,1692345314,1858373641
"Yemen, Rep.",2017,12143491448186,26818703093,7524,0,1,659962041,1643037967,2303000008
"Yemen, Rep.",2018,13608151864638,26914402224,7524,0,1,717549995,1876595108,2594145103
